1111111111
1P00000001
1000000E01
100000C001
1111111111
