111111111111111111111111111111
1P0001000100000000000100000001
100001010100000000000100000001
100000010100000000000100000001
111111110100000000000000000001
100000010100000000000100000001
100000010100000000000100000001
100000010111110011000100000001
100000000100000001000100000001
100000111101000001000100000001
100000000001000001000001C10001
111111111111000000000001C10001
100000000000CC0000000001C11111
100000000000000000000001CCCCE1
111111111111111111111111111111
