111111111111111111111111111111
1P00010001000000000001000000C1
10000101010C000000000100000001
100000010100000000000100000001
111111110100000000000000000001
1C0000010100000000000100000001
100000010100000000000100000001
100000010111110011000100000001
100000000100000001000100000001
100000111101000001000100000001
100000000001000001000001010001
111111111111000000000001C10001
100000000000000000000001011111
1C00000000000000000000010000E1
111111111111111111111111111111
