111111111111111111111111111111
1P1000000000000000000000000001
101000000000000000000000000001
101000C0000000000000000000C001
101000000000000000000000000001
101000000000000000000000000001
1010000000C0000000000000000001
101000000000000000000000000001
10100000000000000000000C000001
101000000000000000000000000001
101000000000000000000000000001
101000000000000000000000000001
101000000000000000000000000001
1000000000000000000000000000E1
111111111111111111111111111111
