1111111111
1P00000001
100C000E01
1111111111
