1111111111
100P000001
100C0000E1
1111111111
