1111111111
1P00000111
1C000001E1
1111111111
