111111111111111111111
1P1000010000000000001
1010000000000000C0101
101000010011111111101
10001001000C000000101
100011100011111110101
1C000C1000000000000E1
100000000000000000001
100000000000000000001
100000000000000000001
100000000000000000001
111111111111111111111
