111111111111111111111
1P00000000000000000C1
100000000000000000001
100000000000000000001
100000000000000000001
100000000000000000001
1C00000000000000000E1
111111111111111111111
