11111111111
10000FFF001
10000FFF001
10000FFF001
10000FFF001
10000FFF001
11111111111
