1111111111111111111111111111111111111
P000000000000000000000000000000000001
1000000000000000000000000000000000001
1000000000000000000000000000000000001
1000000000000000000000000000000000001
1000000000000000000000000000000000001
100000000000000000000000000000000000E
1111111111111111111111111111111111111

0 = vide
1 = mure
P = entre
E = exit
C = collect
