111111111111111111111111111111
1P000000000C0000000000000000C1
100000000000000000000000000001
100000000000000000000000000001
10000000C000000000C00000000001
10000000000000000000000000C001
100000000000000000000000000001
100C00000000000000000000000001
10000000000C0000000000000C0001
100000000000000000000000000001
10000C000000000000000000000001
1000000000000000000000C0000001
10000000000000C000000000000001
1C00000000000000000000000000E1
111111111111111111111111111111
